圣墟	shengxu
一念永恒	yinianyongheng
今日新鲜事	jinrixinxianshi
龙王传说	longwangchuanshuo
武炼巅峰	wuliandianfeng
nba	nba
元尊	yuanzun
飞剑问道	feijianwendao
万古神帝	wangushendi
秋霞	qiuxia
逆天邪神	nitianxieshen
猎场	liechang
我的体育老师	wodetiyulaoshi
致我们单纯的小美好	zhiwomendanchundexiaomeihao
不朽凡人	buxiufanren
王者荣耀	wangzherongyao
帝霸	diba
永夜君王	yongyejunwang
寻梦环游记	xunmenghuanyouji
杨建平	yangjianping
校花的贴身高手	xiaohuadetieshengaoshou
胡一天	huyitian
修罗武神	xiuluowushen
最强狂兵	zuiqiangkuangbing
生逢灿烂的日子	shengfengcanlanderizi
荒野行动	huangyexingdong
全职法师	quanzhifashi
星座	xingzuo
牧神记	mushenji
演员的诞生	yanyuandedansheng
无翼鸟	wuyiniao
作业帮	zuoyebang
海上牧云记	haishangmuyunji
剑来	jianlai
我的世界	wodeshijie
小猪佩奇	xiaozhupeiqi
盖世帝尊	gaishidizun
龙珠超	longzhuchao
混沌剑神	hundunjianshen
万能钥匙	wannengyaoshi
球球大作战	qiuqiudazuozhan
海贼王	haizeiwang
大道朝天	dadaochaotian
绝地求生	juediqiusheng
韩剧网	hanjuwang
烟花	yanhua
迷你世界	minishijie
情侣头像	qinglvtouxiang
张嘉译	zhangjiayi
真武世界	zhenwushijie
葫芦侠	huluxia
寒门崛起	hanmenjueqi
nba直播	nbazhibo
人皇纪	renhuangji
沈月	shenyue
新浪体育	xinlangtiyu
赵丽颖	zhaoliying
斗破苍穹	doupocangqiong
道君	daojun
飞剑问道我吃西红柿	feijianwendaowochixihongshi
qq头像	qqtouxiang
迪丽热巴	dilireba
我是至尊	woshizhizun
万道剑尊	wandaojianzun
万域之王	wanyuzhiwang
电影天堂	dianyingtiantang
iphonex	iphonex
斗破苍穹漫画	doupocangqiongmanhua
王晓晨	wangxiaochen
彭昱畅	pengyuchang
百度地图	baiduditu
新商盟	xinshangmeng
斗战狂潮	douzhankuangchao
60只蚊子写作文	60zhiwenzixiezuowen
无敌天下	wuditianxia
九州海上牧云记	jiuzhouhaishangmuyunji
快乐大本营	kuailedabenying
无敌剑域	wudijianyu
战狼2	zhanlang2
4399游戏盒	4399youxihe
西成高铁	xichenggaotie
五行天	wuxingtian
斗罗大陆3龙王传说	douluodalu3longwangchuanshuo
逍遥小书生	xiaoyaoxiaoshusheng
大魏宫廷	daweigongting
汉乡	hanxiang
关晓彤	guanxiaotong
历史乱套了	lishiluantaole
大主宰	dazhuzai
新高校老师	xingaoxiaolaoshi
元尊天蚕土豆	yuanzuntiancantudou
鹿晗	luhan
cba	cba
溏心风暴3	tangxinfengbao3
熊出没	xiongchumo
神藏	shencang
英伦对决	yinglunduijue
nba录像	nbaluxiang
苹果x	pingguox
熊出没之探险日记	xiongchumozhitanxianriji
王珂	wangke
天骄战纪	tianjiaozhanji
超级兵王	chaojibingwang
凡人修仙传仙界篇	fanrenxiuxianzhuanxianjiepian
至尊剑皇	zhizunjianhuang
电视剧	dianshiju
柴碧云	chaibiyun
微信头像	weixintouxiang
头像	touxiang
你好旧时光	nihaojiushiguang
任娇	renjiao
刘涛	liutao
范冰冰	fanbingbing
天才枪手	tiancaiqiangshou
中国地图	zhongguoditu
太古神王	taigushenwang
三生三世十里桃花	sanshengsanshishilitaohua
易烊千玺	yiyangqianxi
将军在上	jiangjunzaishang
生逢灿烂	shengfengcanlan
王俊凯	wangjunkai
3d字谜	3dzimi
大王饶命	dawangraoming
乾坤剑神	qiankunjianshen
异世界的美食家	yishijiedemeishijia
奥特曼	aoteman
万古天帝	wangutiandi
斗罗大陆	douluodalu
都市超级医圣	dushichaojiyisheng
手抄报	shouchaobao
杨幂	yangmi
九星霸体决	jiuxingbatijue
红烧肉的做法	hongshaoroudezuofa
武神天下	wushentianxia
黄圣依	huangshengyi
极光之恋	jiguangzhilian
吃鸡	chiji
邪王追妻废材逆天小姐	xiewangzhuiqifeichainitianxiaojie
从仙侠世界归来	congxianxiashijieguilai
于明加	yumingjia
穿越火线	chuanyuehuoxian
阚清子	kanqingzi
章子怡	zhangziyi
暖爱	nuanai
日历	rili
急诊科医生	jizhenkeyisheng
凡人修仙传	fanrenxiuxianzhuan
陈龙	chenlong
cctv5节目表	ccvt5jiemubiao
胡歌	huge
怡红院	yihongyuan
可乐鸡翅的做法	kelejichidezuofa
猎场剧情	liechangjuqing
流星雨	liuxingyu
杨建平被喷水	yangjianpingbeipenshui
绝地求生手游	juediqiushengshouyou
贞观大闲人	zhenguandaxianren
陶虹	taohong
重生完美时代	chongshengwanmeishidai
青衣	qingyi
知乎	zhihu
龙珠超118	longzhuchao118
高德地图	gaodeditu
造化之王	zaohuazhiwang
斗罗大陆漫画	douluodalumanhua
白夜追凶	baiyezhuixiong
我的1979	wode1979
龙符	longfu
赘婿	zhuixu
球球大作战刷棒棒糖	qiuqiudazuozhanshuabangbangtang
重生之最强剑神	chongshengzhizuiqiangjianshen
圣墟最新章节	shengxuzuixinzhangjie
绕口令	raokouling
漫画	manhua
养父的花样年华	yangfudehuayangnianhua
永恒国度	yonghengguodu
逍遥兵王	xiaoyaobingwang
极品全能学生	jipinquannengxuesheng
光荣使命	guangrongshiming
火影忍者	huoyingrenzhe
重生之财源滚滚	chongshengzhicaiyuangungun
明星大侦探	mingxingdazhentan
超级神基因	chaojishenjiyin
华为mate10	huaweimate10
地图	ditu
仙路至尊	xianluzhizun
qq空间	qqkongjian
白洁	baijie
vivo	vivo
中俄联合反恐演训	zhongelianhefankongyanxun
凯迪拉克	kaidilake
十九大	shijiuda
吃鸡是什么游戏	chijishishenmeyouxi
小米	xiaomi
晋江	jinjiang
校花的贴身高手最新章节	xiaohuadetieshengaoshouzuixinzhangjie
天唐锦绣	tiantangjinxiu
iphone	iphone
瓜子二手车直卖网	guaziershouchezhimaiwang
游戏	youxi
个性签名	gexingqianming
刘亦菲	liuyifei
二手车	ershouche
美团外卖	meituanwaimai
习近平	xijinping
十二生肖	shiershengxiao
水瓶座	shuipingzuo
我不是精英	wobushijingying
处女座	chunvzuo
赵今麦	zhaojinmai
春香传	chunxiangzhuan
末代皇后	modaihuanghou
最强神话帝皇	zuiqiangshenhuadihuang
怀孕初期症状	huaiyunchuqizhengzhuang
步步惊心	bubujingxin
我的神秘老公	wodeshenmilaogong
巨蟹座	juxiezuo
蓝盈莹	lanyingying
苏宁易购	suningyigou
斗破苍穹之无上之境	doupocangqiongzhiwushangzhijing
双鱼座	shuangyuzuo
白羊座	baiyangzuo
永远的7日之都	yonghengdeqirizhidu
双子座	shuangzizuo
正义联盟	zhengyilianmeng
章龄之	zhanglingzhi
蛊真人	guzhenren
完美世界	wanmeishijie
李念与刘嘉玲合照	linianheliujialinghezhao
凌天战尊	lingtianzhanzun
鬼父	guifu
烟花电影	yanhuadianying
女子工作时被杀害	nvzigongzuoshibeishahai
爱寻迷	aixunmi
狮子座	shizizuo
生日祝福语	shengrizhufuyu
超级飞侠	chaojifeixia
柳岩	liuyan
云南百人齐跳菜	yunnanbairenqitiaocai
郑爽	zhengshuang
高胜美	gaoshengmei
丰田	fengtian
本田	bentian
瓜子二手车	guaziershouche
永恒圣帝	yonghengshengdi
艾滋病初期症状	aizibingchuqizhengzhuang
猎场演员表	liechangyanyuanbiao
克里斯申请离婚	kelisishenqinglihun
奔驰	benchi
哈弗h6	hafuh6
星座运势	xingzuoyunshi
逆鳞	nilin
婉容	wanrong
近身狂兵	jinshenkuangbing
欢场春梦	huanchangchunmeng
九真九阳	jiuzhenjiuyang
海贼王漫画	haizeiwangmanhua
八项规定表情包	baxiangguidingbiaoqingbao
神道丹尊	shendaodanzun
神医凰后	shenyihuanghou
遮天	zhetian
武道大帝	wudaodadi
马云	mayun
宝骏510	baojun510
丁香五月	dixiangwuyue
非诚勿扰	feichengwurao
薛之谦	xuezhiqian
顺产侧切	shunchanceqie
国模	guomo
漫画大全	manhuadaquan
黄淑芬	huangshufen
校园之护花兵王	xiaoyuanzhihuhuabingwang
情侣网名	qinglvwangming
武炼巅峰最新章节	wuliandianfengzuixinzhangjie
乡村小神医	xiangcunxiaoshenyi
万界天尊	wanjietianzun
新视觉	xinshijue
喜迎十九手抄报图片大全	xiyingshijiushouchaobaotupiandaquan
极道天魔	jidaotianmo
茅山捉鬼人	maoshanzhuoguiren
植物大战僵尸	zhiwudazhanjiangshi
儿科医生	erkeyisheng
绝世武神	jueshiwushen
独步天下	dubutianxia
动漫头像	dongmantouxiang
杨洋	yangyang
小猪佩奇动画片全集	xiaozhupeiqidonghuapianquanji
女总裁的贴身兵王	nvzongcaidetieshenbingwang
奶爸的文艺人生	naibadewenyirensheng
周记	zhouji
超品透视	chaopintoushi
百度云	baiduyun
荣耀v10	rongyaov10
汪汪队	wangwangdui
不灭武尊	bumiewuzun
我的贴身校花	wodetieshenxiaohua
陈志朋	chenzhipeng
英超	yingchao
tfboys	tfboys
武练巅峰	wuliandianfeng
西游记	xiyouji
打屁股	dapigu
七界武神	qijiewushen
头像女	touxiangnv
艾滋病	aizibing
韩雪	hanxue
我的绝色总裁未婚妻	wodejuesezongcaiweihunqi
唐嫣	tangyan
白袍总管	baipaozongguan
武动乾坤	wudongqiankun
武破九荒	wupojiuhuang
葫芦侠三楼	huluxiasanlou
终结者2	zhongjiezhe2
异常生物见闻录	yichangshengwujianwenlu
撒谎作文	sahuangzuowen
执魔	zhimo
抗日之特战兵王	kangrizhitezhanbingwang
万茜	wanqian
我老婆是冰山女总裁	wolaoposhibingshannvzongcai
作文	zuowen
火车票	huochepiao
尊上	zushang
保姆的私密日记	baomudesimiriji
致我们单纯的小美好百度云	zhiwomendanchundexiaomeihaobaiduyun
小美好	xiaomeihao
你的名字	nidemingzi
搜狗	sougou
韩美空军联合演习	hanmeikongjunlianheyanxi
最强弃少	zuiqiangqishao
吃240万霸王餐	chi240yuanbawangcan
寒门状元	hanmenzhuangyuan
日本漫画	ribenmanhua
解救吾先生	jiejiuwuxiansheng
王维维	wangweiwei
人体艺术写真	rentiyishuxiezhen
qq分组	qqfenzu
纯阳武神	chunyangwushen
九州牧云记	jiuzhoumuyunji
短发发型	duanfafaxing
猎场结局	liechangjieju
决战平安京	juezhanpinganjing
影视大全	yingshidaquan
车晓	chexiao
亚马逊	yamaxun
诸神的棋盘	zhushendeqipan
恐龙	konglong
炉石传说	lushichuanshuo
爱情和战争	aiqinghezhanzheng
修罗武神最新章节	xiuluowushenzuixinzhangjie
李丽珍	lilizhen
吞天记	tuntianji
无法拥抱的你	wufayongbaodeni
早安心语	zaoanxinyu
风车动漫	fengchedongman
英雄联盟	yingxionglianmeng
斗地主	doudizhu
捷德奥特曼	jiedeaoteman
乌镇	wuzhen
网易云音乐	wangyiyunyinyue
保时捷	baoshijie
我和春天有个约会	wohechuntianyougeyuehui
三星s8	sanxings8
特种兵在都市	tezhongbingzaidushi
龙血武帝	longxuewudi
一拳超人	yiquanchaoren
动态图	dongtaitu
太湖字谜	taihuzimi